ncols         32
nrows         21
xllcorner     1828468.4137837
yllcorner     565764.23474553
cellsize      340
NODATA_value  -9999
-9999 -9999 -9999 -9999 -9999 -9999 -2075 -2075 -1950 -2000 -9999 -9999 -9999 -9999 -9999 -9999 -9999 -9999 -9999 -9999 -9999 -9999 -9999 -9999 -9999 -9999 -9999 -9999 -9999 -9999 -9999 -9999 
-9999 -2000 -2000 1925 -2075 -2050 -1975 -1900 -1875 -1950 -2000 -9999 -9999 -9999 -9999 -9999 -9999 -9999 -9999 -9999 -9999 -9999 -9999 -9999 -9999 -9999 -9999 -9999 -9999 -9999 -9999 -9999 
-9999 -1975 -1875 -1875 -1850 -1875 -1875 -1850 -1825 -1875 -1975 -9999 -9999 -9999 -9999 -9999 -9999 -9999 -9999 -9999 -9999 -9999 -9999 -9999 -9999 -9999 -9999 -9999 -9999 -9999 -9999 -9999 
-9999 -1950 -1850 -1825 -1825 -1825 -1825 -1825 -1800 -1800 -1875 -1975 -2000 -9999 -9999 -9999 -9999 -9999 -9999 -9999 -9999 -9999 -9999 -9999 -9999 -9999 -9999 -9999 -9999 -9999 -9999 -9999 
-2000 -1950 -1850 -1775 -1800 -1775 -1750 -1725 -1700 -1700 -1700 -1875 -1875 -1875 -9999 -9999 -9999 -1825 -1825 -9999 -9999 -9999 -9999 -9999 -9999 -9999 -9999 -9999 -9999 -9999 -9999 -9999 
-2000 -1875 -1825 -1750 -1775 -1750 -1725 -1700 -1675 -1675 -1675 -1700 -1800 -1800 -1800 -1800 -1800 -1775 -1750 -1825 -9999 -9999 -1750 -1750 -1750 -9999 -9999 -9999 -9999 -9999 -9999 -9999 
-2000 -1975 -1850 -1825 -1700 -1725 -1700 -1675 -1675 -1650 -1650 -1700 -1700 -1750 -1775 -1775 -1750 -1725 -1725 -1725 -1775 -1750 -1725 -1650 -1725 -1675 -9999 -9999 -9999 -9999 -9999 -9999 
-9999 -2000 -1975 -1850 -1700 -1700 -1700 -1675 -1650 -1650 -9999 -1650 -1650 -1650 -1650 -1675 -1675 -1675 -1675 -1725 -1725 -1725 -1650 -1625 -1625 -1650 -9999 -9999 -9999 -9999 -9999 -9999 
-9999 -9999 -9999 -9999 -1900 -1700 -1700 -1675 -1650 -9999 -9999 -9999 -9999 -9999 -9999 -1650 -1650 -1650 -1650 -1650 -1700 -1650 -1600 -1600 -1600 -1650 -9999 -9999 -9999 -9999 -9999 -9999 
-9999 -9999 -9999 -9999 -9999 -1875 -1725 -1675 -1650 -9999 -1625 -1625 -1625 -1625 -9999 -9999 -9999 -9999 -9999 -9999 -9999 -9999 -1625 -1625 -9999 -1650 -1675 -9999 -1700 -9999 -9999 -9999 
-9999 -9999 -9999 -9999 -9999 -9999 -1875 -1675 -1650 -9999 -1625 -9999 -9999 -1625 -1625 -1625 -9999 -9999 -9999 -9999 -9999 -9999 -9999 -9999 -9999 -9999 -1650 -1675 -9999 -9999 -9999 -9999 
-9999 -9999 -9999 -9999 -9999 -9999 -9999 -1700 -1650 -1650 -1625 -1625 -9999 -9999 -9999 -1625 -1625 -1625 -1625 -1625 -1625 -9999 -9999 -9999 -9999 -9999 -1650 -9999 -9999 -9999 -9999 -9999 
-9999 -9999 -9999 -9999 -9999 -9999 -9999 -1875 -1725 -1675 -1650 -1625 -1625 -9999 -9999 -9999 -9999 -9999 -9999 -9999 -9999 -1625 -9999 -9999 -9999 -9999 -9999 -1650 -1675 -9999 -9999 -9999 
-9999 -9999 -9999 -9999 -9999 -9999 -9999 -9999 -1875 -1700 -1675 -1650 -9999 -1625 -1625 -1625 -1625 -1600 -1600 -1600 -9999 -9999 -1625 -9999 -9999 -9999 -1650 -9999 -9999 -9999 -9999 -9999 
-9999 -9999 -9999 -9999 -9999 -9999 -9999 -9999 -9999 -9999 -1725 -1675 -1650 -9999 -1625 -1625 -1625 -1600 -1600 -1600 -1600 -9999 -1625 -9999 -1650 -1675 -9999 -9999 -9999 -1675 -1700 -9999 
-9999 -9999 -9999 -9999 -9999 -9999 -9999 -9999 -9999 -9999 -9999 -1700 -9999 -1675 -1625 -1625 -9999 -9999 -1600 -1600 -1600 -9999 -1625 -9999 -1675 -9999 -9999 -9999 -1675 -9999 -9999 -1700 
-9999 -9999 -9999 -9999 -9999 -9999 -9999 -9999 -9999 -9999 -9999 -1875 -9999 -1725 -1675 -1650 -9999 -9999 -1625 -1625 -1625 -1625 -1625 -9999 -9999 -9999 -9999 -9999 -9999 -9999 -9999 -1700 
-9999 -9999 -9999 -9999 -9999 -9999 -9999 -9999 -9999 -9999 -9999 -9999 -9999 -1875 -1700 -1675 -1650 -9999 -9999 -9999 -9999 -9999 -9999 -1650 -9999 -9999 -9999 -9999 -9999 -9999 -9999 -9999 
-9999 -9999 -9999 -9999 -9999 -9999 -9999 -9999 -9999 -9999 -9999 -9999 -9999 -9999 -9999 -9999 -1725 -1675 -1650 -9999 -1650 -1650 -1650 -9999 -1675 -9999 -9999 -1700 -9999 -9999 -9999 -9999 
-9999 -9999 -9999 -9999 -9999 -9999 -9999 -9999 -9999 -9999 -9999 -9999 -9999 -9999 -9999 -1875 -9999 -1700 -1700 -9999 -1675 -1675 -9999 -1675 -1700 -9999 -9999 -9999 -9999 -9999 -9999 -9999 
-9999 -9999 -9999 -9999 -9999 -9999 -9999 -9999 -9999 -9999 -9999 -9999 -9999 -9999 -9999 -9999 -9999 -1725 -9999 -9999 -1700 -9999 -1700 -9999 -9999 -9999 -9999 -9999 -9999 -9999 -9999 -9999 
