ncols         64
nrows         70
xllcorner     1819366.5951709
yllcorner     552256.36290582
cellsize      340
NODATA_value  -9999
0 0 -9999 -9999 -9999 -9999 -9999 -9999 -9999 -9999 -9999 -9999 -9999 -9999 -9999 -9999 -9999 -9999 -9999 -9999 -9999 -9999 -9999 -9999 -9999 -9999 -9999 -9999 -9999 -9999 -9999 -9999 -9999 -9999 -9999 -9999 -9999 -9999 -9999 -9999 -9999 -9999 -9999 -9999 -9999 -9999 -9999 -9999 -9999 -9999 -9999 -9999 -9999 -9999 -9999 -9999 -9999 -9999 -9999 -9999 -9999 -9999 -9999 -9999 
-9999 -9999 -9999 -9999 -9999 -9999 -9999 -9999 -9999 -9999 -9999 -9999 -9999 -9999 -9999 -9999 -9999 -9999 -9999 -9999 -9999 -9999 -9999 -9999 -9999 -9999 -9999 -9999 -9999 -9999 -9999 -9999 -9999 -9999 -9999 -9999 -9999 -9999 -9999 -9999 -9999 -9999 -9999 -9999 -9999 -9999 -9999 -9999 -9999 -9999 -9999 -9999 -9999 -9999 -9999 -9999 -9999 -9999 -9999 -9999 -9999 -9999 -9999 -9999 
-9999 -9999 -9999 -9999 -9999 -9999 -9999 -9999 -9999 -9999 -9999 -9999 -9999 -9999 -9999 -9999 -9999 -9999 -9999 -9999 -9999 -9999 -9999 -9999 -9999 -9999 -9999 -9999 -9999 -9999 -9999 -9999 -9999 -9999 -9999 -9999 -9999 -9999 -9999 -9999 -9999 -9999 -9999 -9999 -9999 -9999 -9999 -9999 -9999 -9999 -9999 -9999 -9999 -9999 -9999 -9999 -9999 -9999 -9999 -9999 -9999 -9999 -9999 -9999 
200 200 200 200 200 -9999 -9999 -9999 -9999 -9999 -9999 -9999 -9999 -9999 -9999 -9999 -9999 -9999 -9999 -9999 -9999 -9999 -9999 -9999 -9999 -9999 -9999 -9999 -9999 -9999 -9999 -9999 -9999 -9999 -9999 -9999 -9999 -9999 -9999 -9999 -9999 -9999 -9999 -9999 -9999 -9999 -9999 -9999 -9999 -9999 -9999 -9999 -9999 -9999 -9999 -9999 -9999 -9999 -9999 -9999 -9999 -9999 -9999 -9999 
-9999 -9999 -9999 -9999 -9999 200 200 -9999 -9999 -9999 -9999 -9999 0 -9999 -9999 -9999 -9999 -9999 -9999 -9999 -9999 -9999 -9999 -9999 -9999 -9999 -9999 -9999 -9999 -9999 -9999 -9999 -9999 -9999 -9999 -9999 -9999 -9999 -9999 -9999 -9999 -9999 -9999 -9999 -9999 -9999 -9999 -9999 -9999 -9999 -9999 -9999 -9999 -9999 -9999 -9999 -9999 -9999 -9999 -9999 -9999 -9999 -9999 -9999 
400 -9999 -9999 -9999 -9999 -9999 -9999 200 -9999 -9999 -9999 -9999 0 -9999 -9999 -9999 -9999 -9999 -9999 -9999 -9999 -9999 -9999 -9999 -9999 -9999 -9999 -9999 -9999 -9999 -9999 -9999 -9999 -9999 -9999 -9999 -9999 -9999 -9999 -9999 -9999 -9999 -9999 -9999 -9999 -9999 -9999 -9999 -9999 -9999 -9999 -9999 -9999 -9999 -9999 -9999 -9999 -9999 -9999 -9999 -9999 -9999 -9999 -9999 
-9999 400 400 400 400 -9999 -9999 -9999 200 -9999 -9999 -9999 0 -9999 -9999 -9999 -200 -9999 -9999 -9999 -9999 -9999 -9999 -9999 -9999 -9999 -9999 -9999 -9999 -9999 -9999 -9999 -9999 -9999 -9999 -9999 -9999 -9999 -9999 -9999 -9999 -9999 -9999 -9999 -9999 -9999 -9999 -9999 -9999 -9999 -9999 -9999 -9999 -9999 -9999 -9999 -9999 -9999 -9999 -9999 -9999 -9999 -9999 -9999 
-9999 -9999 -9999 -9999 400 -9999 -9999 -9999 200 -9999 -9999 -9999 0 -9999 -9999 -9999 -200 -9999 -9999 -9999 -9999 -9999 -9999 -9999 -9999 -9999 -9999 -9999 -9999 -9999 -9999 -9999 -9999 -9999 -9999 -9999 -9999 -9999 -9999 -9999 -9999 -9999 -9999 -9999 -9999 -9999 -9999 -9999 -9999 -9999 -9999 -9999 -9999 -9999 -9999 -9999 -9999 -9999 -9999 -9999 -9999 -9999 -9999 -9999 
600 -9999 -9999 -9999 -9999 400 -9999 -9999 200 200 -9999 -9999 0 -9999 -9999 -200 -200 -9999 -9999 -9999 -9999 -400 -9999 -9999 -9999 -9999 -9999 -9999 -9999 -9999 -9999 -9999 -9999 -9999 -9999 -9999 -9999 -9999 -9999 -9999 -9999 -9999 -9999 -9999 -9999 -9999 -9999 -9999 -9999 -9999 -9999 -9999 -9999 -9999 -9999 -9999 -9999 -9999 -9999 -9999 -9999 -9999 -9999 -9999 
-9999 600 600 -9999 -9999 400 400 -9999 -9999 200 -9999 0 -9999 -9999 -9999 -200 -9999 -9999 -9999 -9999 -400 -9999 -9999 -9999 -9999 -9999 -9999 -9999 -9999 -9999 -9999 -9999 -9999 -9999 -9999 -9999 -9999 -9999 -9999 -9999 -9999 -9999 -9999 -9999 -9999 -9999 -9999 -9999 -9999 -9999 -9999 -9999 -9999 -9999 -9999 -9999 -9999 -9999 -9999 -9999 -9999 -9999 -9999 -9999 
-9999 -9999 -9999 600 -9999 -9999 400 -9999 200 -9999 -9999 0 -9999 -9999 -200 -9999 -9999 -9999 -400 -400 -9999 -9999 -9999 -9999 -9999 -9999 -9999 -9999 -9999 -9999 -9999 -9999 -9999 -9999 -9999 -9999 -9999 -9999 -9999 -9999 -9999 -9999 -9999 -9999 -9999 -9999 -9999 -9999 -9999 -9999 -9999 -9999 -9999 -9999 -9999 -9999 -9999 -9999 -9999 -9999 -9999 -9999 -9999 -9999 
-9999 -9999 -9999 600 -9999 -9999 400 -9999 200 -9999 -9999 0 -9999 -9999 -200 -9999 -9999 -400 -400 -9999 -9999 -9999 -9999 -9999 -9999 -9999 -9999 -9999 -600 -9999 -9999 -9999 -9999 -9999 -9999 -9999 -9999 -9999 -9999 -9999 -9999 -9999 -9999 -9999 -9999 -9999 -9999 -9999 -9999 -9999 -9999 -9999 -9999 -9999 -9999 -9999 -9999 -9999 -9999 -9999 -9999 -9999 -9999 -9999 
-9999 -9999 -9999 600 -9999 400 -9999 -9999 200 -9999 0 -9999 -9999 -200 -9999 -9999 -400 -400 -9999 -9999 -9999 -9999 -9999 -9999 -9999 -9999 -9999 -9999 -600 -9999 -9999 -9999 -9999 -9999 -9999 -9999 -9999 -9999 -9999 -9999 -9999 -9999 -9999 -9999 -9999 -9999 -9999 -9999 -9999 -9999 -9999 -9999 -9999 -9999 -9999 -9999 -9999 -9999 -9999 -9999 -9999 -9999 -9999 -9999 
-9999 -9999 600 -9999 -9999 400 -9999 -9999 200 -9999 0 -9999 -9999 -200 -9999 -9999 -400 -9999 -9999 -9999 -9999 -9999 -9999 -9999 -9999 -9999 -9999 -600 -9999 -9999 -9999 -9999 -9999 -9999 -800 -9999 -9999 -9999 -9999 -9999 -9999 -9999 -9999 -9999 -9999 -9999 -9999 -9999 -9999 -9999 -9999 -9999 -9999 -9999 -9999 -9999 -9999 -9999 -9999 -9999 -9999 -9999 -9999 -9999 
-9999 600 -9999 -9999 400 400 -9999 200 -9999 -9999 0 -9999 -200 -9999 -9999 -400 -9999 -9999 -9999 -9999 -9999 -9999 -9999 -9999 -9999 -9999 -600 -9999 -9999 -9999 -9999 -9999 -9999 -800 -800 -9999 -9999 -9999 -9999 -9999 -9999 -9999 -9999 -9999 -9999 -9999 -9999 -9999 -9999 -9999 -9999 -9999 -9999 -9999 -9999 -9999 -9999 -9999 -9999 -9999 -9999 -9999 -9999 -9999 
-9999 -9999 -9999 400 400 -9999 200 -9999 -9999 0 -9999 -9999 -200 -9999 -400 -400 -9999 -9999 -9999 -9999 -9999 -9999 -9999 -9999 -9999 -600 -9999 -9999 -9999 -9999 -9999 -9999 -9999 -800 -9999 -9999 -9999 -1000 -9999 -9999 -9999 -9999 -9999 -9999 -9999 -9999 -9999 -9999 -9999 -9999 -9999 -9999 -9999 -9999 -9999 -9999 -9999 -9999 -9999 -9999 -9999 -9999 -9999 -9999 
-9999 -9999 400 -9999 -9999 200 200 -9999 0 -9999 -9999 -200 -9999 -9999 -400 -9999 -9999 -9999 -9999 -9999 -9999 -9999 -9999 -9999 -9999 -600 -9999 -9999 -9999 -9999 -9999 -9999 -9999 -800 -9999 -9999 -1000 -9999 -9999 -9999 -1200 -9999 -9999 -9999 -9999 -9999 -9999 -9999 -9999 -9999 -9999 -9999 -9999 -9999 -9999 -9999 -9999 -9999 -9999 -9999 -9999 -9999 -9999 -9999 
-9999 -9999 -9999 -9999 200 200 -9999 0 -9999 -200 -200 -9999 -9999 -400 -400 -9999 -9999 -9999 -9999 -9999 -9999 -9999 -9999 -9999 -9999 -9999 -600 -9999 -9999 -9999 -9999 -9999 -9999 -800 -9999 -9999 -1000 -9999 -9999 -1200 -1200 -9999 -9999 -1400 -9999 -9999 -9999 -9999 -9999 -9999 -9999 -9999 -9999 -9999 -9999 -9999 -9999 -9999 -9999 -9999 -9999 -9999 -9999 -9999 
-9999 -9999 -9999 200 -9999 0 0 -9999 -200 -200 -9999 -9999 -400 -400 -9999 -9999 -9999 -9999 -9999 -9999 -9999 -9999 -9999 -9999 -9999 -9999 -600 -600 -9999 -9999 -9999 -9999 -9999 -800 -9999 -1000 -9999 -9999 -1200 -9999 -9999 -9999 -1400 -1400 -9999 -9999 -9999 -9999 -9999 -9999 -9999 -9999 -9999 -9999 -9999 -9999 -9999 -9999 -9999 -9999 -9999 -9999 -9999 -9999 
-9999 -9999 -9999 -9999 0 0 -9999 -200 -200 -9999 -9999 -400 -9999 -9999 -9999 -9999 -9999 -9999 -9999 -9999 -9999 -9999 -9999 -9999 -9999 -9999 -9999 -9999 -600 -600 -9999 -9999 -9999 -800 -9999 -1000 -9999 -1200 -9999 -9999 -9999 -1400 -1400 -9999 -9999 -9999 -9999 -1600 -9999 -9999 -9999 -9999 -9999 -9999 -9999 -9999 -9999 -9999 -9999 -9999 -9999 -9999 -9999 -9999 
-9999 -9999 -9999 -9999 -9999 -200 -200 -9999 -9999 -400 -400 -9999 -9999 -9999 -600 -600 -600 -600 -9999 -9999 -9999 -9999 -9999 -9999 -400 -400 -400 -9999 -9999 -9999 -600 -9999 -800 -9999 -9999 -1000 -9999 -1200 -9999 -1400 -1400 -9999 -9999 -9999 -9999 -9999 -9999 -1600 -9999 -9999 -9999 -9999 -9999 -9999 -9999 -9999 -9999 -9999 -9999 -9999 -9999 -9999 -9999 -9999 
-9999 -9999 -9999 -9999 -9999 -200 -9999 -400 -400 -9999 -9999 -9999 -600 -600 -9999 -9999 -9999 -9999 -600 -600 -9999 -9999 -9999 -400 -400 -9999 -9999 -400 -400 -9999 -600 -9999 -800 -9999 -1000 -9999 -1200 -9999 -1400 -9999 -9999 -9999 -9999 -9999 -9999 -9999 -1600 -1600 -9999 -9999 -9999 -1800 -9999 -9999 -9999 -9999 -9999 -9999 -9999 -9999 -9999 -9999 -9999 -9999 
-9999 -9999 -9999 -9999 -9999 -400 -400 -9999 -9999 -600 -600 -600 -9999 -9999 -9999 -9999 -9999 -9999 -9999 -9999 -600 -9999 -9999 -400 -9999 -200 -200 -200 -9999 -400 -600 -9999 -800 -9999 -1000 -9999 -1200 -1400 -9999 -1600 -1600 -1600 -1600 -1600 -9999 -9999 -1600 -9999 -9999 -9999 -1800 -9999 -1800 -9999 -9999 -9999 -9999 -9999 -9999 -9999 -9999 -9999 -9999 -9999 
-9999 -9999 -9999 -9999 -9999 -9999 -9999 -600 -600 -9999 -9999 -9999 -800 -800 -800 -800 -800 -800 -800 -9999 -9999 -600 -600 -400 -9999 -200 0 -9999 -200 -400 -9999 -600 -800 -9999 -1000 -1200 -9999 -1400 -1600 -9999 -9999 -9999 -9999 -9999 -1600 -1600 -9999 -9999 -1800 -1800 -9999 -9999 -1800 -1800 -9999 -9999 -9999 -9999 -9999 -9999 -9999 -9999 -9999 -9999 
-9999 -9999 -9999 -9999 -9999 -9999 -600 -9999 -9999 -800 -800 -800 -9999 -9999 -9999 -9999 -9999 -9999 -9999 -800 -800 -800 -600 -600 -400 -200 0 0 -9999 -200 -400 -600 -800 -800 -1000 -1200 -1400 -1600 -1800 -1800 -1800 -1800 -1800 -9999 -9999 -9999 -9999 -9999 -1800 -9999 -9999 -9999 -9999 -9999 -9999 -9999 -9999 -9999 -9999 -2000 -9999 -9999 -9999 -9999 
-9999 -9999 -9999 -9999 -9999 -9999 -9999 -800 -800 -9999 -9999 -1000 -1000 -1000 -1000 -1000 -1000 -1000 -1000 -1000 -1000 -1000 -800 -800 -600 -200 0 0 -200 -200 -400 -600 -9999 -800 -1000 -1200 -1400 -1600 -1800 -2000 -2000 -9999 -9999 -1800 -9999 -9999 -9999 -1800 -9999 -9999 -2000 -2000 -2000 -2000 -2000 -2000 -2000 -2000 -2000 -2000 -9999 -9999 -9999 -9999 
-9999 -9999 -9999 -9999 -9999 -9999 -9999 -9999 -9999 -1000 -1000 -1000 -9999 -9999 -9999 -1200 -1200 -1200 -1200 -1200 -1200 -1200 -1200 -1000 -1000 -800 -400 -200 -200 -400 -400 -600 -9999 -800 -1000 -1200 -1600 -1800 -2000 -9999 -9999 -2000 -9999 -1800 -1800 -9999 -1800 -9999 -2000 -2000 -9999 -9999 -9999 -9999 -9999 -9999 -9999 -9999 -9999 -9999 -9999 -9999 -9999 -9999 
-9999 -9999 -9999 -9999 -9999 -9999 -9999 -9999 -1000 -9999 -9999 -1200 -1200 -1200 -1200 -9999 -9999 -9999 -1400 -1400 -1400 -1400 -1400 -1400 -1400 -1000 -800 -600 -600 -600 -9999 -600 -9999 -800 -1000 -1200 -1400 -1800 -2000 -9999 -9999 -2000 -2000 -9999 -1800 -1800 -9999 -2000 -9999 -9999 -9999 -9999 -9999 -9999 -9999 -9999 -9999 -9999 -9999 -9999 -9999 -9999 -9999 -9999 
-9999 -9999 -9999 -9999 -9999 -9999 -9999 -9999 -9999 -1200 -1200 -9999 -9999 -1400 -1400 -1400 -1400 -1400 -9999 -1600 -1600 -1600 -1600 -1800 -1600 -1400 -1000 -800 -800 -800 -600 -600 -800 -1000 -1000 -1200 -1400 -1800 -2000 -9999 -9999 -9999 -2000 -9999 -9999 -9999 -9999 -2000 -9999 -9999 -9999 -9999 -9999 -9999 -9999 -9999 -9999 -9999 -9999 -9999 -9999 -9999 -9999 -9999 
-9999 -9999 -9999 -9999 -9999 -9999 -9999 -9999 -9999 -9999 -1400 -1400 -1400 -9999 -9999 -1600 -1600 -1600 -1600 -9999 -1800 -1800 -1800 -2000 -2000 -1600 -1400 -1200 -1200 -1000 -800 -9999 -800 -1000 -1200 -9999 -1400 -1400 -2000 -9999 -9999 -9999 -9999 -2000 -2000 -9999 -2000 -9999 -9999 -9999 -9999 -2200 -2200 -9999 -9999 -9999 -9999 -9999 -9999 -9999 -9999 -9999 -9999 -9999 
-9999 -9999 -9999 -9999 -9999 -9999 -9999 -9999 -9999 -9999 -1400 -9999 -9999 -1600 -1600 -1600 -9999 -1800 -1800 -1800 -9999 -2000 -2000 -2200 -2200 -2000 -1800 -1600 -1400 -1200 -1000 -800 -9999 -1000 -1200 -9999 -1400 -1400 -1400 -1400 -9999 -9999 -2200 -2000 -9999 -9999 -2000 -9999 -9999 -2200 -2200 -9999 -9999 -2200 -9999 -9999 -9999 -9999 -9999 -9999 -9999 -9999 -9999 -9999 
-9999 -9999 -9999 -9999 -9999 -9999 -9999 -9999 -9999 -9999 -1600 -1600 -1600 -9999 -9999 -1800 -1800 -9999 -9999 -2000 -2000 -9999 -2200 -9999 -2400 -2200 -2200 -2000 -1800 -1400 -1200 -1000 -1000 -1200 -1400 -1400 -1400 -9999 -9999 -9999 -9999 -2200 -9999 -2000 -9999 -9999 -2000 -2200 -2200 -2200 -9999 -9999 -9999 -2200 -9999 -9999 -9999 -9999 -9999 -9999 -9999 -2000 -2000 -9999 
-9999 -9999 -9999 -9999 -9999 -9999 -9999 -9999 -9999 -9999 -9999 -9999 -9999 -1800 -1800 -1800 -9999 -2000 -2000 -9999 -9999 -2200 -9999 -2400 -2600 -2600 -2400 -2200 -2000 -1600 -1400 -1200 -1200 -1400 -1400 -9999 -9999 -9999 -9999 -9999 -9999 -9999 -9999 -9999 -9999 -2000 -2000 -2200 -9999 -9999 -9999 -9999 -2200 -2200 -9999 -9999 -9999 -9999 -9999 -2000 -2000 -9999 -2000 -9999 
-9999 -9999 -9999 -9999 -9999 -9999 -9999 -9999 -9999 -9999 -9999 -1800 -1800 -9999 -9999 -9999 -2000 -2000 -9999 -9999 -2200 -9999 -2400 -2600 -9999 -2800 -2800 -2600 -2400 -1800 -1600 -1800 -1400 -1600 -1800 -1800 -9999 -9999 -9999 -9999 -9999 -9999 -9999 -9999 -2000 -2000 -9999 -2200 -2200 -9999 -9999 -9999 -2200 -9999 -9999 -9999 -9999 -9999 -2000 -9999 -9999 -9999 -2000 -9999 
-9999 -9999 -9999 -9999 -9999 -9999 -9999 -9999 -9999 -9999 -9999 -9999 -9999 -9999 -2000 -2000 -9999 -9999 -9999 -2200 -9999 -9999 -2400 -2600 -2600 -2800 -9999 -2800 -2800 -2600 -2400 -2200 -1800 -1800 -2000 -2000 -2000 -1600 -1600 -1600 -1600 -1600 -1600 -1600 -9999 -2200 -2200 -2200 -9999 -9999 -9999 -2200 -2200 -9999 -9999 -9999 -9999 -9999 -2000 -9999 -9999 -2000 -2000 -9999 
-9999 -9999 -9999 -9999 -9999 -9999 -9999 -9999 -9999 -9999 -9999 -9999 -9999 -2000 -9999 -9999 -9999 -2200 -2200 -9999 -9999 -9999 -2400 -2400 -2600 -2800 -9999 -3000 -3000 -2800 -2600 -2400 -2200 -2200 -2200 -2200 -9999 -2000 -9999 -9999 -9999 -9999 -9999 -9999 -9999 -9999 -9999 -9999 -9999 -9999 -2200 -9999 -9999 -9999 -9999 -9999 -9999 -9999 -2000 -9999 -9999 -2000 -9999 -9999 
-9999 -9999 -9999 -9999 -9999 -9999 -9999 -9999 -9999 -9999 -9999 -9999 -9999 -9999 -9999 -2200 -2200 -9999 -9999 -9999 -9999 -9999 -9999 -2400 -9999 -2600 -2800 -3200 -3200 -3000 -2800 -2600 -2400 -2400 -2400 -2400 -2200 -2200 -2000 -2000 -9999 -9999 -9999 -9999 -9999 -9999 -9999 -9999 -9999 -2200 -9999 -9999 -9999 -9999 -9999 -9999 -9999 -9999 -2000 -9999 -9999 -2000 -9999 -9999 
-9999 -9999 -9999 -9999 -9999 -9999 -9999 -9999 -9999 -9999 -9999 -9999 -9999 -9999 -2200 -2200 -9999 -9999 -9999 -9999 -9999 -9999 -9999 -2400 -9999 -2600 -2800 -3200 -9999 -3200 -3000 -2800 -2600 -2600 -2600 -2600 -2400 -2400 -2400 -2200 -2000 -2000 -9999 -9999 -9999 -9999 -9999 -9999 -9999 -2200 -9999 -9999 -9999 -9999 -9999 -9999 -9999 -9999 -9999 -2000 -2000 -9999 -9999 -9999 
-9999 -9999 -9999 -9999 -9999 -9999 -9999 -9999 -9999 -9999 -9999 -9999 -9999 -9999 -9999 -9999 -9999 -2400 -2400 -2400 -2400 -2400 -2400 -9999 -9999 -2600 -2800 -3200 -3400 -3200 -3000 -9999 -2800 -2800 -2800 -2600 -2600 -2600 -2600 -2600 -2400 -2200 -2000 -2000 -9999 -9999 -9999 -9999 -9999 -2200 -9999 -9999 -9999 -9999 -9999 -9999 -9999 -9999 -9999 -9999 -9999 -9999 -9999 -9999 
-9999 -9999 -9999 -9999 -9999 -9999 -9999 -9999 -9999 -9999 -9999 -9999 -9999 -9999 -9999 -2400 -2400 -9999 -9999 -9999 -9999 -9999 -9999 -2600 -2600 -9999 -9999 -3200 -3400 -3400 -3200 -3000 -3000 -9999 -9999 -2800 -2800 -2800 -2800 -2800 -2800 -2600 -2400 -2400 -2200 -2200 -9999 -9999 -9999 -9999 -2200 -2200 -9999 -9999 -9999 -9999 -9999 -9999 -9999 -9999 -9999 -9999 -9999 -9999 
-9999 -9999 -9999 -9999 -9999 -9999 -9999 -9999 -9999 -9999 -9999 -9999 -9999 -9999 -9999 -9999 -9999 -9999 -9999 -9999 -9999 -9999 -2600 -9999 -9999 -9999 -9999 -2800 -3400 -3400 -3400 -3200 -3000 -3000 -3000 -3000 -3000 -3000 -3000 -3000 -3000 -3000 -2800 -2600 -2400 -2200 -9999 -9999 -9999 -9999 -9999 -2200 -9999 -9999 -9999 -9999 -9999 -9999 -9999 -9999 -9999 -9999 -9999 -9999 
-9999 -9999 -9999 -9999 -9999 -9999 -9999 -9999 -9999 -9999 -9999 -9999 -9999 -9999 -9999 -9999 -9999 -9999 -9999 -9999 -9999 -2600 -2600 -2600 -9999 -2600 -9999 -3400 -9999 -3600 -3600 -3400 -3200 -3200 -9999 -3200 -3200 -3200 -9999 -3200 -3200 -3200 -3000 -2800 -2600 -2400 -2200 -9999 -9999 -9999 -9999 -9999 -2200 -2200 -2200 -2200 -2200 -2200 -2200 -2200 -9999 -9999 -9999 -9999 
-9999 -9999 -9999 -9999 -9999 -9999 -9999 -9999 -9999 -9999 -9999 -9999 -9999 -9999 -9999 -9999 -9999 -9999 -9999 -9999 -9999 -9999 -9999 -9999 -2600 -2400 -2600 -2800 -3600 -9999 -3800 -3600 -3600 -3400 -3200 -3200 -9999 -9999 -3200 -3400 -3400 -3400 -3200 -3000 -2800 -2400 -2200 -2200 -2200 -2400 -9999 -9999 -9999 -9999 -9999 -9999 -9999 -9999 -9999 -9999 -2200 -9999 -9999 -9999 
-9999 -9999 -9999 -9999 -9999 -9999 -9999 -9999 -9999 -9999 -9999 -9999 -9999 -9999 -9999 -9999 -9999 -9999 -9999 -9999 -9999 -9999 -2400 -2400 -2200 -2200 -2400 -2600 -3400 -3600 -3800 -3800 -3600 -3600 -3400 -3400 -3400 -3400 -3400 -3400 -3600 -3600 -3400 -3200 -3000 -2600 -2400 -9999 -2400 -2600 -2400 -9999 -9999 -9999 -2400 -2400 -2400 -2400 -9999 -9999 -9999 -2200 -2200 -2200 
-9999 -9999 -9999 -9999 -9999 -9999 -9999 -9999 -9999 -9999 -9999 -9999 -9999 -9999 -9999 -9999 -9999 -9999 -9999 -9999 -9999 -2400 -9999 -2200 -2000 -2000 -2000 -2400 -2800 -3600 -9999 -3800 -3800 -3800 -3800 -3600 -3600 -3600 -3600 -3600 -3600 -3600 -9999 -3400 -3000 -2800 -2600 -2400 -9999 -2800 -2400 -2400 -2400 -2400 -9999 -9999 -9999 -9999 -2400 -9999 -9999 -9999 -9999 -9999 
-9999 -9999 -9999 -9999 -9999 -9999 -9999 -9999 -9999 -9999 -9999 -9999 -9999 -9999 -9999 -9999 -9999 -9999 -9999 -9999 -2400 -9999 -9999 -2200 -2000 -2000 -2000 -2400 -2800 -4000 -4000 -4000 -9999 -9999 -9999 -3800 -9999 -9999 -9999 -9999 -3600 -3600 -9999 -3400 -3200 -3000 -2800 -2600 -2600 -2600 -2400 -2400 -9999 -2600 -2600 -9999 -9999 -9999 -9999 -2400 -9999 -9999 -9999 -9999 
-9999 -9999 -9999 -9999 -9999 -9999 -9999 -9999 -9999 -9999 -9999 -9999 -9999 -9999 -9999 -9999 -9999 -9999 -9999 -9999 -2400 -9999 -9999 -2200 -9999 -9999 -2200 -2400 -2800 -3000 -3200 -9999 -4000 -9999 -9999 -9999 -3800 -3800 -3800 -9999 -3600 -3600 -3600 -3400 -3200 -3000 -9999 -2800 -2800 -2600 -9999 -2600 -2600 -9999 -2600 -2600 -9999 -9999 -9999 -9999 -2400 -2400 -9999 -9999 
-9999 -9999 -9999 -9999 -9999 -9999 -9999 -9999 -9999 -9999 -9999 -9999 -9999 -9999 -9999 -9999 -9999 -9999 -9999 -9999 -2400 -9999 -9999 -9999 -2200 -2200 -2400 -2600 -2800 -3000 -3200 -9999 -4000 -9999 -9999 -9999 -9999 -9999 -3800 -9999 -9999 -9999 -3600 -3400 -9999 -3200 -3000 -3000 -3000 -2800 -2800 -2800 -2800 -2800 -9999 -9999 -2600 -2600 -9999 -9999 -9999 -9999 -9999 -9999 
-9999 -9999 -9999 -9999 -9999 -9999 -9999 -9999 -9999 -9999 -9999 -9999 -9999 -9999 -9999 -9999 -9999 -9999 -9999 -9999 -9999 -2400 -2400 -2400 -2400 -2400 -2600 -2800 -2800 -3000 -3200 -3400 -4000 -9999 -9999 -3800 -9999 -9999 -3800 -3800 -9999 -9999 -3600 -9999 -3400 -9999 -3200 -9999 -9999 -3000 -3000 -3000 -9999 -9999 -2800 -9999 -9999 -9999 -2600 -9999 -9999 -9999 -9999 -9999 
-9999 -9999 -9999 -9999 -9999 -9999 -9999 -9999 -9999 -9999 -9999 -9999 -9999 -9999 -9999 -9999 -9999 -9999 -9999 -9999 -9999 -9999 -9999 -9999 -9999 -2600 -2800 -2800 -3000 -3200 -9999 -3400 -3600 -9999 -3800 -3800 -3800 -3800 -3800 -9999 -9999 -9999 -3600 -3600 -3400 -9999 -9999 -3200 -9999 -3200 -3200 -9999 -3000 -3000 -9999 -2800 -9999 -9999 -9999 -9999 -9999 -9999 -9999 -9999 
-9999 -9999 -9999 -9999 -9999 -9999 -9999 -9999 -9999 -9999 -9999 -9999 -9999 -9999 -9999 -9999 -9999 -9999 -9999 -9999 -9999 -9999 -2600 -2600 -2600 -2800 -2800 -3000 -3200 -3200 -3400 -3600 -3600 -9999 -9999 -3800 -9999 -9999 -9999 -9999 -9999 -9999 -9999 -3600 -3400 -3400 -9999 -3200 -3200 -9999 -3200 -3200 -9999 -3000 -3000 -9999 -2800 -2800 -9999 -9999 -9999 -9999 -9999 -9999 
-9999 -9999 -9999 -9999 -9999 -9999 -9999 -9999 -9999 -9999 -9999 -9999 -9999 -9999 -9999 -9999 -9999 -9999 -9999 -9999 -9999 -9999 -9999 -2800 -2800 -9999 -3000 -3200 -3200 -3400 -3600 -3600 -9999 -3800 -3800 -3800 -9999 -3600 -3600 -3600 -3600 -3600 -3600 -3600 -9999 -3400 -9999 -3200 -9999 -9999 -9999 -3200 -9999 -9999 -3000 -9999 -9999 -9999 -9999 -9999 -9999 -9999 -9999 -9999 
-9999 -9999 -9999 -9999 -9999 -9999 -9999 -9999 -9999 -9999 -9999 -9999 -9999 -9999 -9999 -9999 -9999 -9999 -9999 -9999 -9999 -9999 -9999 -2800 -3000 -3000 -9999 -3200 -3400 -3600 -3600 -3800 -3800 -3800 -3800 -3600 -3600 -3600 -9999 -3400 -9999 -3400 -3400 -3400 -9999 -3400 -9999 -9999 -9999 -3200 -3200 -9999 -9999 -9999 -3000 -9999 -9999 -9999 -9999 -9999 -9999 -9999 -9999 -9999 
-9999 -9999 -9999 -9999 -9999 -9999 -9999 -9999 -9999 -9999 -9999 -9999 -9999 -9999 -9999 -9999 -9999 -9999 -9999 -9999 -9999 -9999 -9999 -3000 -9999 -3200 -3200 -3400 -3600 -9999 -3800 -9999 -9999 -4000 -3800 -3600 -3400 -9999 -3400 -9999 -3400 -9999 -9999 -9999 -3400 -3400 -3200 -3200 -3200 -3200 -9999 -9999 -9999 -9999 -9999 -9999 -9999 -9999 -9999 -9999 -9999 -9999 -9999 -9999 
-9999 -9999 -9999 -9999 -9999 -9999 -9999 -9999 -9999 -9999 -9999 -9999 -9999 -9999 -9999 -9999 -9999 -9999 -9999 -9999 -9999 -9999 -9999 -9999 -3200 -9999 -3400 -9999 -3600 -9999 -3800 -9999 -4000 -9999 -4000 -3600 -3400 -3400 -3200 -3200 -3200 -3200 -3200 -3200 -3200 -3200 -3200 -9999 -9999 -9999 -9999 -9999 -9999 -9999 -9999 -9999 -9999 -9999 -9999 -9999 -9999 -9999 -9999 -9999 
-9999 -9999 -9999 -9999 -9999 -9999 -9999 -9999 -9999 -9999 -9999 -9999 -9999 -9999 -9999 -9999 -9999 -9999 -9999 -9999 -9999 -9999 -9999 -9999 -9999 -3400 -9999 -3600 -9999 -9999 -3800 -3800 -9999 -4000 -4000 -3600 -3200 -3000 -3000 -3000 -3000 -3000 -3000 -3000 -3000 -3000 -9999 -3200 -3200 -3200 -9999 -9999 -9999 -9999 -9999 -9999 -9999 -9999 -9999 -9999 -9999 -9999 -9999 -9999 
-9999 -9999 -9999 -9999 -9999 -9999 -9999 -9999 -9999 -9999 -9999 -9999 -9999 -9999 -9999 -9999 -9999 -9999 -9999 -9999 -9999 -9999 -9999 -9999 -9999 -9999 -9999 -3600 -9999 -9999 -9999 -9999 -3800 -3800 -3600 -3400 -3200 -2800 -2800 -2800 -2800 -2800 -2800 -2800 -2800 -3000 -3000 -9999 -9999 -9999 -9999 -9999 -9999 -9999 -9999 -9999 -9999 -9999 -9999 -9999 -9999 -9999 -9999 -9999 
-9999 -9999 -9999 -9999 -9999 -9999 -9999 -9999 -9999 -9999 -9999 -9999 -9999 -9999 -9999 -9999 -9999 -9999 -9999 -9999 -9999 -9999 -9999 -9999 -9999 -9999 -3600 -9999 -9999 -9999 -9999 -9999 -3600 -3600 -3400 -3200 -3000 -2600 -2600 -2600 -2600 -2600 -2600 -9999 -9999 -2800 -3000 -3000 -9999 -9999 -9999 -9999 -9999 -9999 -9999 -9999 -9999 -9999 -9999 -9999 -9999 -9999 -9999 -9999 
-9999 -9999 -9999 -9999 -9999 -9999 -9999 -9999 -9999 -9999 -9999 -9999 -9999 -9999 -9999 -9999 -9999 -9999 -9999 -9999 -9999 -9999 -9999 -9999 -9999 -9999 -9999 -9999 -9999 -9999 -9999 -3600 -3400 -3400 -3200 -3000 -2800 -2600 -2400 -2200 -2400 -2400 -2400 -2600 -9999 -2800 -3000 -9999 -9999 -9999 -9999 -9999 -9999 -9999 -9999 -9999 -9999 -9999 -9999 -9999 -9999 -9999 -9999 -9999 
-9999 -9999 -9999 -9999 -9999 -9999 -9999 -9999 -9999 -9999 -9999 -9999 -9999 -9999 -9999 -9999 -9999 -9999 -9999 -9999 -9999 -9999 -9999 -9999 -9999 -9999 -9999 -9999 -9999 -9999 -3600 -9999 -3400 -3200 -3000 -2800 -2600 -2400 -2000 -2000 -2200 -2200 -2400 -2400 -2600 -2800 -3000 -3000 -9999 -9999 -9999 -9999 -9999 -9999 -9999 -9999 -9999 -9999 -9999 -9999 -9999 -9999 -9999 -9999 
-9999 -9999 -9999 -9999 -9999 -9999 -9999 -9999 -9999 -9999 -9999 -9999 -9999 -9999 -9999 -9999 -9999 -9999 -9999 -9999 -9999 -9999 -9999 -9999 -9999 -9999 -9999 -9999 -9999 -3600 -9999 -3400 -3200 -3000 -2800 -2600 -2400 -2000 -2000 -1800 -1800 -2000 -2000 -2200 -2400 -2600 -2800 -9999 -9999 -9999 -9999 -9999 -9999 -9999 -9999 -9999 -9999 -9999 -9999 -9999 -9999 -9999 -9999 -9999 
-9999 -9999 -9999 -9999 -9999 -9999 -9999 -9999 -9999 -9999 -9999 -9999 -9999 -9999 -9999 -9999 -9999 -9999 -9999 -9999 -9999 -9999 -9999 -9999 -9999 -9999 -9999 -9999 -9999 -3600 -3400 -3400 -3200 -3000 -2600 -2400 -2200 -1800 -1600 -1600 -1600 -1800 -1800 -2000 -2200 -2400 -9999 -9999 -9999 -9999 -9999 -9999 -9999 -9999 -9999 -9999 -9999 -9999 -9999 -9999 -9999 -9999 -9999 -9999 
-9999 -9999 -9999 -9999 -9999 -9999 -9999 -9999 -9999 -9999 -9999 -9999 -9999 -9999 -9999 -9999 -9999 -9999 -9999 -9999 -9999 -9999 -9999 -9999 -9999 -9999 -9999 -9999 -9999 -9999 -3400 -3200 -3000 -2800 -2600 -2200 -2000 -1600 -1400 -1400 -1400 -1600 -1600 -2000 -9999 -9999 -9999 -9999 -9999 -9999 -9999 -9999 -9999 -9999 -9999 -9999 -9999 -9999 -9999 -9999 -9999 -9999 -9999 -9999 
-9999 -9999 -9999 -9999 -9999 -9999 -9999 -9999 -9999 -9999 -9999 -9999 -9999 -9999 -9999 -9999 -9999 -9999 -9999 -9999 -9999 -9999 -9999 -9999 -9999 -9999 -9999 -9999 -9999 -9999 -3400 -3200 -3000 -2800 -2600 -2200 -1800 -1400 -1200 -1200 -9999 -1400 -1600 -9999 -9999 -9999 -9999 -9999 -9999 -9999 -9999 -9999 -9999 -9999 -9999 -9999 -9999 -9999 -9999 -9999 -9999 -9999 -9999 -9999 
-9999 -9999 -9999 -9999 -9999 -9999 -9999 -9999 -9999 -9999 -9999 -9999 -9999 -9999 -9999 -9999 -9999 -9999 -9999 -9999 -9999 -9999 -9999 -9999 -9999 -9999 -9999 -9999 -9999 -9999 -3400 -3200 -3000 -2800 -2600 -2200 -2000 -1600 -1400 -1200 -1200 -9999 -9999 -9999 -9999 -9999 -9999 -9999 -9999 -9999 -9999 -9999 -9999 -9999 -9999 -9999 -9999 -9999 -9999 -9999 -9999 -9999 -9999 -9999 
-9999 -9999 -9999 -9999 -9999 -9999 -9999 -9999 -9999 -9999 -9999 -9999 -9999 -9999 -9999 -9999 -9999 -9999 -9999 -9999 -9999 -9999 -9999 -9999 -9999 -9999 -9999 -9999 -9999 -9999 -9999 -9999 -3200 -2800 -2600 -2400 -2000 -1800 -1400 -1400 -9999 -9999 -9999 -9999 -9999 -9999 -9999 -9999 -9999 -9999 -9999 -9999 -9999 -9999 -9999 -9999 -9999 -9999 -9999 -9999 -9999 -9999 -9999 -9999 
-9999 -9999 -9999 -9999 -9999 -9999 -9999 -9999 -9999 -9999 -9999 -9999 -9999 -9999 -9999 -9999 -9999 -9999 -9999 -9999 -9999 -9999 -9999 -9999 -9999 -9999 -9999 -9999 -9999 -9999 -9999 -9999 -3200 -3000 -2800 -2400 -2200 -1800 -1600 -9999 -9999 -9999 -9999 -9999 -9999 -9999 -9999 -9999 -9999 -9999 -9999 -9999 -9999 -9999 -9999 -9999 -9999 -9999 -9999 -9999 -9999 -9999 -9999 -9999 
-9999 -9999 -9999 -9999 -9999 -9999 -9999 -9999 -9999 -9999 -9999 -9999 -9999 -9999 -9999 -9999 -9999 -9999 -9999 -9999 -9999 -9999 -9999 -9999 -9999 -9999 -9999 -9999 -9999 -9999 -9999 -9999 -3200 -3000 -2800 -2600 -2400 -2000 -9999 -9999 -9999 -9999 -9999 -9999 -9999 -9999 -9999 -9999 -9999 -9999 -9999 -9999 -9999 -9999 -9999 -9999 -9999 -9999 -9999 -9999 -9999 -9999 -9999 -9999 
-9999 -9999 -9999 -9999 -9999 -9999 -9999 -9999 -9999 -9999 -9999 -9999 -9999 -9999 -9999 -9999 -9999 -9999 -9999 -9999 -9999 -9999 -9999 -9999 -9999 -9999 -9999 -9999 -9999 -9999 -9999 -9999 -9999 -3200 -3000 -2800 -9999 -9999 -9999 -9999 -9999 -9999 -9999 -9999 -9999 -9999 -9999 -9999 -9999 -9999 -9999 -9999 -9999 -9999 -9999 -9999 -9999 -9999 -9999 -9999 -9999 -9999 -9999 -9999 
-9999 -9999 -9999 -9999 -9999 -9999 -9999 -9999 -9999 -9999 -9999 -9999 -9999 -9999 -9999 -9999 -9999 -9999 -9999 -9999 -9999 -9999 -9999 -9999 -9999 -9999 -9999 -9999 -9999 -9999 -9999 -9999 -9999 -9999 -3200 -9999 -9999 -9999 -9999 -9999 -9999 -9999 -9999 -9999 -9999 -9999 -9999 -9999 -9999 -9999 -9999 -9999 -9999 -9999 -9999 -9999 -9999 -9999 -9999 -9999 -9999 -9999 -9999 -9999 
