ncols         25
nrows         24
xllcorner     1828731.6350746
yllcorner     566713.1615377
cellsize      340
NODATA_value  -9999
-9999 -9999 -9999 -9999 -1625 -1600 -1675 -9999 -9999 -9999 -9999 -9999 -9999 -9999 -9999 -9999 -9999 -9999 -9999 -9999 -9999 -9999 -9999 -9999 -9999 
-9999 -9999 -9999 -9999 -1625 -1600 -1625 -1675 -9999 -9999 -9999 -9999 -9999 -9999 -9999 -9999 -9999 -9999 -9999 -9999 -9999 -9999 -9999 -9999 -9999 
-9999 -9999 -9999 -1675 -1650 -1600 -1600 -1675 -9999 -9999 -9999 -9999 -9999 -9999 -9999 -9999 -9999 -9999 -9999 -9999 -9999 -9999 -9999 -9999 -9999 
-9999 -9999 -9999 -1675 -1675 -1625 -1600 -1625 -9999 -9999 -9999 -9999 -9999 -9999 -9999 -9999 -9999 -9999 -9999 -9999 -9999 -9999 -9999 -9999 -9999 
-9999 -9999 -9999 -9999 -1675 -1675 -1625 -1650 1775 -1900 -9999 -9999 -9999 -9999 -9999 -9999 -9999 -9999 -9999 -9999 -9999 -9999 -9999 -9999 -9999 
-9999 -9999 -9999 -9999 -9999 -1675 -1675 -1650 -1800 -1900 -9999 -9999 -9999 -9999 -9999 -9999 -9999 -9999 -9999 -9999 -9999 -9999 -9999 -9999 -9999 
-9999 -1850 -1825 -1750 -9999 -1700 -9999 -1675 -1875 -1875 -9999 -9999 -9999 -9999 -9999 -9999 -9999 -9999 -9999 -9999 -9999 -9999 -9999 -9999 -9999 
-1850 -1825 -1700 -1675 -1675 -1675 -1675 -1625 -1750 -1825 -1850 -9999 -9999 -9999 -9999 -9999 -9999 -9999 -9999 -9999 -9999 -9999 -9999 -9999 -9999 
-1800 -1775 -1650 -1575 -1575 -1575 -1575 -1575 -1575 -1650 -1825 -1850 -9999 -9999 -9999 -9999 -9999 -9999 -9999 -9999 -9999 -9999 -9999 -9999 -9999 
-9999 -1725 -1675 -1575 -1550 -1550 -1500 -1500 -1450 -1500 -1650 -1650 -9999 -9999 -9999 -9999 -9999 -9999 -9999 -9999 -9999 -9999 -9999 -9999 -9999 
-9999 -1650 -1650 -1600 -1500 -1450 -1425 -1400 -1400 -1400 -1500 -1600 -1625 -1625 -9999 -9999 -9999 -9999 -9999 -9999 -9999 -9999 -1550 -9999 -9999 
-9999 -1600 -1625 -1575 -1500 -1425 -1375 -1375 -1375 -1375 -1425 -1500 -1500 -1625 -1550 -1550 -1550 -1525 -1550 -1550 -1550 -1550 -1475 -1375 -9999 
-9999 -9999 -1550 -1525 -1500 -1400 -1375 -1350 -9999 -1350 -1350 -1375 -1375 -1400 -1525 -1525 -1525 -1500 -1500 -1550 -1550 -1475 -1275 -1200 -1200 
-9999 -9999 -1550 -1500 -1475 -1425 -1375 -1350 -1325 -1325 -1325 -1350 -1350 -1350 -1375 -1400 -1425 -1400 -1425 -1450 -1425 -1425 -1225 -1150 -1150 
-9999 -9999 -9999 -1500 -1500 -1450 -1375 -1350 -1325 -1325 -1325 -1325 -1325 -1350 -1375 -1375 -1375 -1400 -1400 -1400 -1400 -1325 -1175 -1150 -9999 
-9999 -9999 -9999 -9999 -9999 -1500 -1500 -1350 -9999 -1325 -1325 -9999 -1325 -1325 -1350 -1375 -1350 -9999 -1375 -9999 -1375 -1275 -1200 -1200 -1150 
-9999 -9999 -9999 -9999 -9999 -9999 -1450 -1450 -1350 -1350 -1325 -1325 -1325 -1325 -1350 -1350 -1350 -1350 -1375 -1375 -9999 -1350 -1275 -1200 -1200 
-9999 -9999 -9999 -9999 -9999 -9999 -9999 -1475 -1450 -1350 -1325 -1325 -1325 -1300 -1325 -1325 -1325 -1350 -1350 -1375 -1375 -1350 -1275 -1275 -1225 
-9999 -9999 -9999 -9999 -9999 -9999 -9999 -9999 -1475 -1350 -1350 -1350 -1325 -1300 -1325 -1325 -1350 -1350 -1350 -1375 -9999 -9999 -9999 -9999 -1275 
-9999 -9999 -9999 -9999 -9999 -9999 -9999 -9999 -9999 -1450 -1450 -1450 -1350 -1325 -1325 -9999 -9999 -9999 -1350 -1375 -9999 -9999 -9999 -9999 -9999 
-9999 -9999 -9999 -9999 -9999 -9999 -9999 -9999 -9999 -9999 -9999 -9999 -1450 -1350 -1325 -9999 -1325 -1325 -1325 -1350 -9999 -9999 -9999 -9999 -9999 
-9999 -9999 -9999 -9999 -9999 -9999 -9999 -9999 -9999 -9999 -9999 -9999 -9999 -1425 -1375 -1350 -1325 -1325 -1325 -1350 -1375 -9999 -9999 -9999 -9999 
-9999 -9999 -9999 -9999 -9999 -9999 -9999 -9999 -9999 -9999 -9999 -9999 -9999 -9999 -9999 -1425 -1400 -1350 -1325 -1350 -1425 -9999 -9999 -9999 -9999 
-9999 -9999 -9999 -9999 -9999 -9999 -9999 -9999 -9999 -9999 -9999 -9999 -9999 -9999 -9999 -9999 -9999 -1425 -1425 -1400 -9999 -9999 -9999 -9999 -9999 
