1.81601e+006 585920 61
1.82191e+006 564203 -11
1.81797e+006 567215 -344
1.83854e+006 562522 543
1.83192e+006 561348 461
1.83519e+006 561060 334
1.83187e+006 563283 1041
1.84484e+006 546453 872
1.86932e+006 537086 1201
